####################################################################
#                                               #                  #
#                                               #                  #
#                                               #                  #
#                                               #                  #
#                                               #                  #
#                                               #                  #
#                                               #                  #
#                                               #                  #
#                                               #                  #
#                                               #                  #
#                                               ####################
#                                               #                  #
#                                               #                  #
#                                               #                  #
#                                               #                  #
#                                               #                  #
#                                               #                  #
#                                               #                  #
#                                               #                  #
#                                               #                  #
#                                               #                  #
####################################################################
#                                                                  #
#                                                                  #
#                                                                  #
#                                                                  #
#                                                                  #
#                                                                  #
####################################################################