~~~~~~~~~~~~~~~~~~~~~~~~~~~~~~~~~~~~~~~~~~~~~~~
~~~~~~~~~~~##``~~~`````^^^``````~~~~~~~~~~~~~~~
~~~~~~~###```````````^^^^^^^`````~~~~~~~```~~~~
~~~~~~~``````****`^^^^`C`^^^^`````~~~~~````~~~~
~~~~~~~~~```*******^^``````^^^`````~~~~`````~~~
~~~~~~~``````***```^^```````^^^```~~~~~~``~~~~~
~~~~~~~~~`````*`````^^^````^^^~````~~~~~~~~~~~~
~~~~~~~##```~`````````^^^^^^``~~```~~~~~~~~~~~~
~~~~~~##```~~~````*````^`∩`^^``~~~~~~~~~~~~~~~~
~~~###``````~~~``**`````````````````~~~~~~~~~~~
~~~~~###`````~````*```````````**``````~~~~~~~~~
~~~~~~~##``````````````````````````~~~~~~~~~~~~
~~~~~~~~~~~~##```````*```````````##~~~~~~~~~~~~
~~~~~~~~~~~~~~###``****``````````###~~~~~~~~~~~
~~~~~``~~~~~~~~##```**``````````##~~~~~~~~~~~~~
~~~#``````~~~~~~~#````````````````~~~~~~~~~~~~~
~~~~``````#~~~~##``````````~~``````#~~~~~~~~~~~
~~~``````#~~~~~~#`````````~~`````##~~~~~~~~~~~~
~~~##```##~~~~~~####`````~~`````#~~~~~~~~~~~~~~
~~~~~~~~~~~~~~~~~#~~~~~~`~~~~~~~~~~~~~~~~~~~~~~
~~~~~~~~~~~~~~~~~~~~~~~~~~~~~~~~~~~~~~~~~~~~~~~